31
15
=                  &         =
=    @             &         =
=*******#*******   &         =
=       #----------&    @    =
=       #    **#   *******#**=
=     G #    **#       @G #  =
=**#*****    ********#*******=
=  #           G     #       =
=*********#**********#       =
=         #          #       =
=       @ #----------#   @   =
=    #******         *******#=
=    #     P      @         #=
=****************************=
==============================
